111111111111111
100002000022201
101212101210101
102222002220201
101213101010101
100000000300201
101012101012101
100022020020001
101012101012101
100022222200201
101210101210101
102020200000001
111111111111111