111111111111111
100000000000301
101012101010101
100002000000001
101010101010101
100000000000001
101012101010101
100000020000001
101010101010101
100000000000001
101010101010101
100000000000001
111111111111111