111111111111111
100002000022201
101212101210101
102222002220201
101213101010101
100000000300201
101012101012101
100022020020001
101012101012101
130022222203201
101210101210101
132020200300001
111111111111111