400000000000000
400002000022200
401212101210100
42222002220200
401213101010100
400000000300200
401012101012100
400022020020000
401012101012100
430022222203200
401210101210100
400000000000000
