111111111111111
111111000111111
111111000111111
100002000022201
101212101210101
102220022202001
101213101010101
100000000300201
101012101012101
100022020020001
101012101012101
130022222203201
111111111111111